"filename", "language", "Python", "JSON", "Markdown", "Draw.io", "comment", "blank", "total"
"d:\My Workspaces\2024\oquant\README.md", "Markdown", 0, 0, 59, 0, 0, 34, 93
"d:\My Workspaces\2024\oquant\arch.drawio", "Draw.io", 0, 0, 0, 246, 0, 0, 246
"d:\My Workspaces\2024\oquant\common\constant.py", "Python", 31, 0, 0, 0, 0, 7, 38
"d:\My Workspaces\2024\oquant\common\option_strategy.ipynb", "JSON", 0, 90, 0, 0, 0, 1, 91
"d:\My Workspaces\2024\oquant\common\utilities.py", "Python", 25, 0, 0, 0, 5, 11, 41
"d:\My Workspaces\2024\oquant\strategy_center\center\base.py", "Python", 144, 0, 0, 0, 0, 56, 200
"d:\My Workspaces\2024\oquant\strategy_center\center\data_feed.py", "Python", 164, 0, 0, 0, 1, 31, 196
"d:\My Workspaces\2024\oquant\strategy_center\center\engine.py", "Python", 23, 0, 0, 0, 10, 12, 45
"d:\My Workspaces\2024\oquant\strategy_center\center\mq.py", "Python", 126, 0, 0, 0, 0, 20, 146
"d:\My Workspaces\2024\oquant\strategy_center\center\option_group.py", "Python", 15, 0, 0, 0, 0, 8, 23
"d:\My Workspaces\2024\oquant\strategy_center\center\store.py", "Python", 208, 0, 0, 0, 1, 39, 248
"d:\My Workspaces\2024\oquant\strategy_center\center\strategies\dual_dragon.py", "Python", 29, 0, 0, 0, 3, 10, 42
"d:\My Workspaces\2024\oquant\strategy_center\center\strategy.py", "Python", 24, 0, 0, 0, 0, 8, 32
"d:\My Workspaces\2024\oquant\strategy_center\center\trader.py", "Python", 145, 0, 0, 0, 2, 22, 169
"d:\My Workspaces\2024\oquant\strategy_center\main.py", "Python", 25, 0, 0, 0, 1, 4, 30
"d:\My Workspaces\2024\oquant\test\mong.ipynb", "JSON", 0, 230, 0, 0, 0, 1, 231
"d:\My Workspaces\2024\oquant\test\mq.ipynb", "JSON", 0, 182, 0, 0, 0, 1, 183
"d:\My Workspaces\2024\oquant\test\test_mq.py", "Python", 54, 0, 0, 0, 6, 9, 69
"Total", "-", 1013, 502, 59, 246, 29, 274, 2123