"filename", "language", "JSON", "Python", "Draw.io", "Markdown", "comment", "blank", "total"
"d:\My Workspaces\2024\oquant\README.md", "Markdown", 0, 0, 0, 59, 0, 34, 93
"d:\My Workspaces\2024\oquant\arch.drawio", "Draw.io", 0, 0, 246, 0, 0, 0, 246
"d:\My Workspaces\2024\oquant\common\constant.py", "Python", 0, 31, 0, 0, 0, 7, 38
"d:\My Workspaces\2024\oquant\common\option_strategy.ipynb", "JSON", 90, 0, 0, 0, 0, 1, 91
"d:\My Workspaces\2024\oquant\common\utilities.py", "Python", 0, 25, 0, 0, 5, 11, 41
"d:\My Workspaces\2024\oquant\strategy_center\center\base.py", "Python", 0, 144, 0, 0, 0, 56, 200
"d:\My Workspaces\2024\oquant\strategy_center\center\data_feed.py", "Python", 0, 164, 0, 0, 1, 31, 196
"d:\My Workspaces\2024\oquant\strategy_center\center\engine.py", "Python", 0, 23, 0, 0, 10, 12, 45
"d:\My Workspaces\2024\oquant\strategy_center\center\mq.py", "Python", 0, 124, 0, 0, 2, 20, 146
"d:\My Workspaces\2024\oquant\strategy_center\center\option_group.py", "Python", 0, 15, 0, 0, 0, 8, 23
"d:\My Workspaces\2024\oquant\strategy_center\center\store.py", "Python", 0, 218, 0, 0, 1, 39, 258
"d:\My Workspaces\2024\oquant\strategy_center\center\strategies\dual_dragon.py", "Python", 0, 35, 0, 0, 0, 10, 45
"d:\My Workspaces\2024\oquant\strategy_center\center\strategy.py", "Python", 0, 24, 0, 0, 0, 8, 32
"d:\My Workspaces\2024\oquant\strategy_center\center\trader.py", "Python", 0, 146, 0, 0, 2, 22, 170
"d:\My Workspaces\2024\oquant\strategy_center\main.py", "Python", 0, 25, 0, 0, 1, 4, 30
"d:\My Workspaces\2024\oquant\test\mong.ipynb", "JSON", 230, 0, 0, 0, 0, 1, 231
"d:\My Workspaces\2024\oquant\test\mq.ipynb", "JSON", 182, 0, 0, 0, 0, 1, 183
"d:\My Workspaces\2024\oquant\test\test_mq.py", "Python", 0, 54, 0, 0, 6, 9, 69
"Total", "-", 502, 1028, 246, 59, 28, 274, 2137