"filename", "language", "Markdown", "Python", "Draw.io", "JSON", "CSV", "comment", "blank", "total"
"d:\My Workspaces\2024\oquant\README.md", "Markdown", 59, 0, 0, 0, 0, 0, 34, 93
"d:\My Workspaces\2024\oquant\arch.drawio", "Draw.io", 0, 0, 260, 0, 0, 0, 0, 260
"d:\My Workspaces\2024\oquant\common\calendar.csv", "CSV", 0, 0, 0, 0, 8313, 0, 1, 8314
"d:\My Workspaces\2024\oquant\common\calendar.py", "Python", 0, 38, 0, 0, 0, 0, 8, 46
"d:\My Workspaces\2024\oquant\common\constant.py", "Python", 0, 31, 0, 0, 0, 0, 8, 39
"d:\My Workspaces\2024\oquant\common\option_strategy.ipynb", "JSON", 0, 0, 0, 83, 0, 0, 1, 84
"d:\My Workspaces\2024\oquant\common\utilities.py", "Python", 0, 25, 0, 0, 0, 5, 11, 41
"d:\My Workspaces\2024\oquant\strategy_center\center\base.py", "Python", 0, 200, 0, 0, 0, 0, 61, 261
"d:\My Workspaces\2024\oquant\strategy_center\center\data_feed.py", "Python", 0, 175, 0, 0, 0, 2, 36, 213
"d:\My Workspaces\2024\oquant\strategy_center\center\engine.py", "Python", 0, 22, 0, 0, 0, 10, 11, 43
"d:\My Workspaces\2024\oquant\strategy_center\center\mq.py", "Python", 0, 129, 0, 0, 0, 2, 20, 151
"d:\My Workspaces\2024\oquant\strategy_center\center\option_group.py", "Python", 0, 15, 0, 0, 0, 0, 8, 23
"d:\My Workspaces\2024\oquant\strategy_center\center\store.py", "Python", 0, 233, 0, 0, 0, 1, 48, 282
"d:\My Workspaces\2024\oquant\strategy_center\center\strategies\dual_dragon.py", "Python", 0, 34, 0, 0, 0, 0, 12, 46
"d:\My Workspaces\2024\oquant\strategy_center\center\strategy.py", "Python", 0, 85, 0, 0, 0, 0, 14, 99
"d:\My Workspaces\2024\oquant\strategy_center\center\trader.py", "Python", 0, 150, 0, 0, 0, 2, 24, 176
"d:\My Workspaces\2024\oquant\strategy_center\main.py", "Python", 0, 26, 0, 0, 0, 1, 4, 31
"d:\My Workspaces\2024\oquant\test\mong.ipynb", "JSON", 0, 0, 0, 257, 0, 0, 1, 258
"d:\My Workspaces\2024\oquant\test\mq.ipynb", "JSON", 0, 0, 0, 182, 0, 0, 1, 183
"d:\My Workspaces\2024\oquant\test\test_mq.py", "Python", 0, 54, 0, 0, 0, 6, 9, 69
"Total", "-", 59, 1217, 260, 522, 8313, 29, 312, 10712