"filename", "language", "Python", "Draw.io", "CSV", "comment", "blank", "total"
"d:\My Workspaces\2024\oquant\arch.drawio", "Draw.io", 0, 14, 0, 0, 0, 14
"d:\My Workspaces\2024\oquant\common\calendar.csv", "CSV", 0, 0, 8313, 0, 1, 8314
"d:\My Workspaces\2024\oquant\common\calendar.py", "Python", 38, 0, 0, 0, 8, 46
"d:\My Workspaces\2024\oquant\strategy_center\center\base.py", "Python", 49, 0, 0, 0, 3, 52
"d:\My Workspaces\2024\oquant\strategy_center\center\data_feed.py", "Python", -1, 0, 0, 0, 0, -1
"d:\My Workspaces\2024\oquant\strategy_center\center\store.py", "Python", 12, 0, 0, 0, 8, 20
"d:\My Workspaces\2024\oquant\strategy_center\center\strategies\dual_dragon.py", "Python", 1, 0, 0, 0, 0, 1
"d:\My Workspaces\2024\oquant\strategy_center\center\strategy.py", "Python", 3, 0, 0, 0, 4, 7
"d:\My Workspaces\2024\oquant\strategy_center\main.py", "Python", 1, 0, 0, 0, 0, 1
"Total", "-", 103, 14, 8313, 0, 24, 8454