"filename", "language", "Python", "Markdown", "JSON", "Draw.io", "CSV", "comment", "blank", "total"
"d:\My Workspaces\2024\oquant\README.md", "Markdown", 0, 59, 0, 0, 0, 0, 34, 93
"d:\My Workspaces\2024\oquant\arch.drawio", "Draw.io", 0, 0, 0, 260, 0, 0, 0, 260
"d:\My Workspaces\2024\oquant\common\calendar.csv", "CSV", 0, 0, 0, 0, 8313, 0, 1, 8314
"d:\My Workspaces\2024\oquant\common\calendar.py", "Python", 38, 0, 0, 0, 0, 0, 8, 46
"d:\My Workspaces\2024\oquant\common\constant.py", "Python", 31, 0, 0, 0, 0, 0, 7, 38
"d:\My Workspaces\2024\oquant\common\option_strategy.ipynb", "JSON", 0, 0, 90, 0, 0, 0, 1, 91
"d:\My Workspaces\2024\oquant\common\utilities.py", "Python", 25, 0, 0, 0, 0, 5, 11, 41
"d:\My Workspaces\2024\oquant\strategy_center\center\base.py", "Python", 199, 0, 0, 0, 0, 0, 61, 260
"d:\My Workspaces\2024\oquant\strategy_center\center\data_feed.py", "Python", 174, 0, 0, 0, 0, 2, 36, 212
"d:\My Workspaces\2024\oquant\strategy_center\center\engine.py", "Python", 21, 0, 0, 0, 0, 10, 11, 42
"d:\My Workspaces\2024\oquant\strategy_center\center\mq.py", "Python", 124, 0, 0, 0, 0, 2, 20, 146
"d:\My Workspaces\2024\oquant\strategy_center\center\option_group.py", "Python", 15, 0, 0, 0, 0, 0, 8, 23
"d:\My Workspaces\2024\oquant\strategy_center\center\store.py", "Python", 230, 0, 0, 0, 0, 1, 47, 278
"d:\My Workspaces\2024\oquant\strategy_center\center\strategies\dual_dragon.py", "Python", 36, 0, 0, 0, 0, 0, 12, 48
"d:\My Workspaces\2024\oquant\strategy_center\center\strategy.py", "Python", 26, 0, 0, 0, 0, 0, 12, 38
"d:\My Workspaces\2024\oquant\strategy_center\center\trader.py", "Python", 150, 0, 0, 0, 0, 2, 24, 176
"d:\My Workspaces\2024\oquant\strategy_center\main.py", "Python", 26, 0, 0, 0, 0, 1, 4, 31
"d:\My Workspaces\2024\oquant\test\mong.ipynb", "JSON", 0, 0, 230, 0, 0, 0, 1, 231
"d:\My Workspaces\2024\oquant\test\mq.ipynb", "JSON", 0, 0, 182, 0, 0, 0, 1, 183
"d:\My Workspaces\2024\oquant\test\test_mq.py", "Python", 54, 0, 0, 0, 0, 6, 9, 69
"Total", "-", 1149, 59, 502, 260, 8313, 29, 308, 10620