"filename", "language", "JSON", "Python", "XML", "comment", "blank", "total"
"d:\My Workspaces\2024\oquant\.idea\workspace.xml", "XML", 0, 0, 6, 0, 0, 6
"d:\My Workspaces\2024\oquant\strategy_center\center\data_feed.py", "Python", 0, 9, 0, 3, 3, 15
"d:\My Workspaces\2024\oquant\strategy_center\center\mq.py", "Python", 0, 8, 0, 194, 33, 235
"d:\My Workspaces\2024\oquant\strategy_center\center\option_group.py", "Python", 0, 5, 0, 0, 1, 6
"d:\My Workspaces\2024\oquant\strategy_center\center\strategies\dual_dragon.py", "Python", 0, 1, 0, 1, 0, 2
"d:\My Workspaces\2024\oquant\strategy_center\center\strategy.py", "Python", 0, 7, 0, -1, 0, 6
"d:\My Workspaces\2024\oquant\strategy_center\center\trader.py", "Python", 0, 117, 0, 5, 23, 145
"d:\My Workspaces\2024\oquant\strategy_center\main.py", "Python", 0, 12, 0, 0, 5, 17
"d:\My Workspaces\2024\oquant\test\mmmq.py", "Python", 0, 150, 0, 11, 31, 192
"d:\My Workspaces\2024\oquant\test\test.ipynb", "JSON", 167, 0, 0, 0, 0, 167
"Total", "-", 167, 309, 6, 213, 96, 791