"filename", "language", "Python", "JSON", "Markdown", "Draw.io", "comment", "blank", "total"
"d:\My Workspaces\2024\oquant\README.md", "Markdown", 0, 0, 59, 0, 0, 34, 93
"d:\My Workspaces\2024\oquant\arch.drawio", "Draw.io", 0, 0, 0, 246, 0, 0, 246
"d:\My Workspaces\2024\oquant\common\constant.py", "Python", 31, 0, 0, 0, 0, 7, 38
"d:\My Workspaces\2024\oquant\common\option_strategy.ipynb", "JSON", 0, 90, 0, 0, 0, 1, 91
"d:\My Workspaces\2024\oquant\common\utilities.py", "Python", 25, 0, 0, 0, 5, 11, 41
"d:\My Workspaces\2024\oquant\strategy_center\center\base.py", "Python", 150, 0, 0, 0, 0, 58, 208
"d:\My Workspaces\2024\oquant\strategy_center\center\data_feed.py", "Python", 175, 0, 0, 0, 2, 36, 213
"d:\My Workspaces\2024\oquant\strategy_center\center\engine.py", "Python", 21, 0, 0, 0, 10, 11, 42
"d:\My Workspaces\2024\oquant\strategy_center\center\mq.py", "Python", 124, 0, 0, 0, 2, 20, 146
"d:\My Workspaces\2024\oquant\strategy_center\center\option_group.py", "Python", 15, 0, 0, 0, 0, 8, 23
"d:\My Workspaces\2024\oquant\strategy_center\center\store.py", "Python", 218, 0, 0, 0, 1, 39, 258
"d:\My Workspaces\2024\oquant\strategy_center\center\strategies\dual_dragon.py", "Python", 35, 0, 0, 0, 0, 12, 47
"d:\My Workspaces\2024\oquant\strategy_center\center\strategy.py", "Python", 23, 0, 0, 0, 0, 8, 31
"d:\My Workspaces\2024\oquant\strategy_center\center\trader.py", "Python", 150, 0, 0, 0, 2, 24, 176
"d:\My Workspaces\2024\oquant\strategy_center\main.py", "Python", 25, 0, 0, 0, 1, 4, 30
"d:\My Workspaces\2024\oquant\test\mong.ipynb", "JSON", 0, 230, 0, 0, 0, 1, 231
"d:\My Workspaces\2024\oquant\test\mq.ipynb", "JSON", 0, 182, 0, 0, 0, 1, 183
"d:\My Workspaces\2024\oquant\test\test_mq.py", "Python", 54, 0, 0, 0, 6, 9, 69
"Total", "-", 1046, 502, 59, 246, 29, 284, 2166